aac	AMINOGLYCOSIDE
aad	AMINOGLYCOSIDE
amp	BETA-LACTAM
ant	AMINOGLYCOSIDE
aph	AMINOGLYCOSIDE
apm	AMINOGLYCOSIDE
arm	AMINOGLYCOSIDE
arr	RIFAMYCIN
bcr	BACITRACIN
bla	BETA-LACTAM
ble	BLEOMYCIN
blm	BLEOMYCIN
car	MACROLIDE
cat	PHENICOL
cbl	BETA-LACTAM
cep	BETA-LACTAM
cfi	BETA-LACTAM
cfr	MACROLIDE/LINCOSAMIDE/STREPTOGRAMIN
cfx	BETA-LACTAM
chr	MACROLIDE
cip	MACROLIDE/LINCOSAMIDE/STREPTOGRAMIN
clb	MACROLIDE/LINCOSAMIDE/STREPTOGRAMIN
cml	PHENICOL
cmr	PHENICOL
cmx	PHENICOL
cph	BETA-LACTAM
imi	BETA-LACTAM
cpt	PHENICOL
crp	FLUOROQUINOLONE
dfr	TRIMETHOPRIM
eat	PLEUROMUTILIN
emt	AVILAMYCIN
ere	MACROLIDE
erm	MACROLIDE
est	PHENICOL
fex	PHENICOL
flo	PHENICOL
fom	FOSFOMYCIN
fos	FOSFOMYCIN
fus	FUSIDIC ACID
grm	AMINOGLYCOSIDE
hug	BETA-LACTAM
iri	RIFAMYCIN
kam	AMINOGLYCOSIDE
lin	LINCOSAMIDE
lnu	LINCOSAMIDE
lsa	LINCOSAMIDE/STREPTOGRAMIN
mcr	COLISTIN
mec	BETA-LACTAM
mef	MACROLIDE
mgt	MACROLIDE
mph	MACROLIDE
msr	MACROLIDE
mup	MUPIROCIN
myr	MACROLIDE
nim	NITROIMIDAZOLE
npm	AMINOGLYCOSIDE
nsh	THIOSTREPTON
ole	MACROLIDE
opt	PHENICOL/OXAZOLIDINONE
oqx	PHENICOL/QUINOLONE
otr	TETRACYCLINE
pen	BETA-LACTAM
pex	PHENICOL
pox	MACROLIDE
qac	QUATERNARY AMMONIUM
qep	QUINOLONE
qnr	QUINOLONE
rgt	RIFAMYCIN
rmt	AMINOGLYCOSIDE
rox	RIFAMYCIN
rph	RIFAMYCIN
sal	LINCOSAMIDE/STREPTOGRAMIN
sat	STREPTOTHRICIN
sgm	AMINOGLYCOSIDE
smr	MULTIDRUG
spd	AMINOGLYCOSIDE
spw	AMINOGLYCOSIDE
srm	MACROLIDE
sta	STREPTOTHRICIN
str	AMINOGLYCOSIDE
sul	SULFONAMIDE
tae	PLEUROMUTILIN
tcm	TETRACENOMYCIN
tcr	TETRACYCLINE
tet	TETRACYCLINE
tlm	BLEOMYCIN
tlr	MACROLIDE
tsn	THIOSTREPTON
van	GLYCOPEPTIDE
var	BETA-LACTAM
vat	STREPTOGRAMIN
vga	LINCOSAMIDE
vgb	STREPTOGRAMIN
vml	MACROLIDE/PLEUROMUTILIN
vph	TUBERACTINOMYCIN
zbm	BLEOMYCIN
16s	TETRACYCLINE
23s	MACROLIDE
50s	MACROLIDE
acr	TETRACYCLINE
bas	COLISTIN
cme	MACROLIDE
cya	FOSMIDOMYCIN
fab	TRICLOSAN
fol	SULFONAMIDE
gyr	QUINOLONE
lon	TETRACYCLINE
mar	MULTIDRUG
mur	FOSFOMYCIN
nfs	NITROFURAN
omp	FOSFOMYCIN
par	QUINOLONE
pmr	COLISTIN
pts	FOSFOMYCIN
ram	MULTIDRUG
rpo	RIFAMYCIN
rps	AMINOGLYCOSIDE
sox	MULTIDRUG
tuf	POLYKETIDE
uhp	FOSFOMYCIN
pom	BETA-LACTAM
fmr	AMINOGLYCOSIDE
kmr	AMINOGLYCOSIDE
kgm	AMINOGLYCOSIDE
mdt	MULTIDRUG
